     #### 
######  #
#       #
#      .#
#o #######
##       #
 # # #   #
 #     . #
 #   #####
 #####
