    #####             
    #   #
    #.  #
  ###  .###
  #  .  . #
### # ### #     ######
#   # ### #######  ..#
# .  .             ..#
##### #### #o####  ..#
    #      ###  ######
    ########
