############  
#    #     ###
#    # .  .  #
#    #.####  #
#      o ##  #
#    # #  . ##
###### ##. . #
  # .  . . . #
  #    #     #
  ############
