  ##### 
###   #
# o.  #
### . #
# ##. #
# #   ##
#.  .. #
#      #
########
