        ######## 
        #     o#
        # .#. ##
        # .  .#
        ##. . #
######### . # ###
#.     ## .  .  #
##       .  .   #
#.     ##########
########
